12
##########################
#    #                 #.#
#    #      $          #.#
#  $ #                 # #
#  $ #                   #
#           #        $   #
#       .   #            #
#    #      #      *     #
#    #      #            #
#   +#      #            # 
#    #      #    #       #
##########################