12
##########################
#    #                 #.#
#    #      $          #.#
#  $ #                 # #
#  $ #                   #
#           #        $  # 
#       .   #           # 
#    #      #      *     #
#    #      #            #
#   +#      #        ##### 
#    #      #    #   #   
######################